22,23,22,23,22,23,22,23,22,23,22,23,22,23,22,23,22,23,22,23,22,23,22,23,22,23,22,23,22,23,22,23,22,23,22,23,22,23,22,23,22,23,22,23,22,23,22,23,22,23,22,23,22,23,22,23,22,23,22,23,22,23,22,23,22,23,22,23,22,23,22,23,22,23,22,23,22,23,22,23,22,23,22,23,22,23,22,23,22,23,22,23,22,23,22,23,22,23,22,23,22,23,22,23,22,23,22,23,22,23,22,23,22,23,22,23,22,23,22,23,22,23,22,23,22,23,22,23,22,23,22,23,22,23,22,23,22,23,22,23,22,23,22,23,22,23,22,23,22,23,22,23,22,23,22,23,22,23,22,23,22,23,22,23,22,23,22,20,21,20,21,20,21,20,21,20,21,20,21,20,21,20,21,20,21,20,21,20,21,20,21,20,21,20,21,20,21,20,21,20,21,20,21,20,21,20,21,20,21,20,21,20,21,20,21,20,21,20,21,20,21,20,21,20,21,20,21,20,21,20,21,20,21,20,21,20,21,20,21,20,21,20,21,20,21,20,21,20,21,20,21,20,21,20,21,20,21,20,21,20,21,20,21,20,21,20,21,20,21,20,21,20,21,20,21,20,21,20,21,20,21,20,21,20,21,20,21,20,21,20,21,20,21,20,21,20,21,20,21,20,21,20,21,20,21,20,21,20,21,20,21,20,21,20,21,20,21,20,21,20,21,20,21,20,21,20,21,20,21,20,21,20,21,20,21,20,21,20,21,20,21,20,21,20,21,20,21,20,21,20,21,20,21,20,21,20,21,20,21,20,21,20,21,20,21,20,21,20,21,20,21,20,21,20,21,20,21,20,21,20,21,20,21,20,21,20,21,20,21,20,21,20,21,20,21,20,21,20,21,20,21,20,21,20,21,20,21,20,21,20,21,20,21,20,21,20,21,20,21,20,21,20,21,20,21,20,21,20,21,20,21,20,21,20,21,20,21,20,21,20,21,20,21,20,21,20,21,20,21,20,21,20,21,20,21,20,21,20,21,20,21,20,21,20,21,20,21,20,21,20,21,20,21,20,21,20,21,20,21,20,21,20,21,20,21,20,21,20,21,20,21,20,21,20,21,20,21,20,21,20,21,20,21,20,21,20,21,20,21,20,21,20
54,55,54,55,54,55,54,55,54,55,54,55,54,55,54,55,54,55,54,55,54,55,54,55,54,55,54,55,54,55,54,55,54,55,54,55,54,55,54,55,54,55,54,55,54,55,54,55,54,55,54,55,54,55,54,55,54,55,54,55,54,55,54,55,54,55,54,55,54,55,54,55,54,55,54,55,54,55,54,55,54,55,54,55,54,55,54,55,54,55,54,55,54,55,54,55,54,55,54,55,54,55,54,55,54,55,54,55,54,55,54,55,54,55,54,55,54,55,54,55,54,55,54,55,54,55,54,55,54,55,54,55,54,55,54,55,54,55,54,55,54,55,54,55,54,55,54,55,54,55,54,55,54,55,54,55,54,55,54,55,54,55,54,55,54,55,54,52,53,52,53,52,53,52,53,52,53,52,53,52,53,52,53,52,53,52,53,52,53,52,53,52,53,52,53,52,53,52,53,52,53,52,53,52,53,52,53,52,53,52,53,52,53,52,53,52,53,52,53,52,53,52,53,52,53,52,53,52,53,52,53,52,53,52,53,52,53,52,53,52,53,52,53,52,53,52,53,52,53,52,53,52,53,52,53,52,53,52,53,52,53,52,53,52,53,52,53,52,53,52,53,52,53,52,53,52,53,52,53,52,53,52,53,52,53,52,53,52,53,52,53,52,53,52,53,52,53,52,53,52,53,52,53,52,53,52,53,52,53,52,53,52,53,52,53,52,53,52,53,52,53,52,53,52,53,52,53,52,53,52,53,52,53,52,53,52,53,52,53,52,53,52,53,52,53,52,53,52,53,52,53,52,53,52,53,52,53,52,53,52,53,52,53,52,53,52,53,52,53,52,53,52,53,52,53,52,53,52,53,52,53,52,53,52,53,52,53,52,53,52,53,52,53,52,53,52,53,52,53,52,53,52,53,52,53,52,53,52,53,52,53,52,53,52,53,52,53,52,53,52,53,52,53,52,53,52,53,52,53,52,53,52,53,52,53,52,53,52,53,52,53,52,53,52,53,52,53,52,53,52,53,52,53,52,53,52,53,52,53,52,53,52,53,52,53,52,53,52,53,52,53,52,53,52,53,52,53,52,53,52,53,52,53,52,53,52,53,52,53,52,53,52,53,52,53,52,53,52,53,52,53,52,53,52,53,52,53,52,53,52,53,52
22,23,22,23,22,23,22,23,22,23,22,23,22,23,22,23,22,23,22,23,22,23,22,23,22,23,22,23,22,23,22,23,22,23,22,23,22,23,22,23,22,23,22,23,22,23,22,23,22,23,22,23,22,23,22,23,22,23,22,23,22,23,22,23,22,23,22,23,22,23,22,23,22,23,22,23,22,23,22,23,22,23,22,23,22,23,22,23,22,23,22,23,22,23,22,23,22,23,22,23,22,23,22,23,22,23,22,23,22,23,22,23,22,23,22,23,22,23,22,23,22,23,22,23,22,23,22,23,22,23,22,23,22,23,22,23,22,23,22,23,22,23,22,23,22,23,22,23,22,23,22,23,22,23,22,23,22,23,22,23,22,23,22,23,22,23,22,20,21,20,21,20,21,20,21,20,21,20,21,20,21,20,21,20,21,20,21,20,21,20,21,20,21,20,21,20,21,20,21,20,21,20,21,20,21,20,21,20,21,20,21,20,21,20,21,20,21,20,21,20,21,20,21,20,21,20,21,20,21,20,21,20,21,20,21,20,21,20,21,20,21,20,21,20,21,20,21,20,21,20,21,20,21,20,21,20,21,20,21,20,21,20,21,20,21,20,21,20,21,20,21,20,21,20,21,20,21,20,21,20,21,20,21,20,21,20,21,20,21,20,21,20,21,20,21,20,21,20,21,20,21,20,21,20,21,20,21,20,21,20,21,20,21,20,21,20,21,20,21,20,21,20,21,20,21,20,21,20,21,20,21,20,21,20,21,20,21,20,21,20,21,20,21,20,21,20,21,20,21,20,21,20,21,20,21,20,21,20,21,20,21,20,21,20,21,20,21,20,21,20,21,20,21,20,21,20,21,20,21,20,21,20,21,20,21,20,21,20,21,20,21,20,21,20,21,20,21,20,21,20,21,20,21,20,21,20,21,20,21,20,21,20,21,20,21,20,21,20,21,20,21,20,21,20,21,20,21,20,21,20,21,20,21,20,21,20,21,20,21,20,21,20,21,20,21,20,21,20,21,20,21,20,21,20,21,20,21,20,21,20,21,20,21,20,21,20,21,20,21,20,21,20,21,20,21,20,21,20,21,20,21,20,21,20,21,20,21,20,21,20,21,20,21,20,21,20,21,20,21,20,21,20,21,20,21,20,21,20,21,20,21,20
54,55,54,55,54,55,54,55,54,55,54,55,54,55,54,55,54,55,54,55,54,55,54,55,54,55,54,55,54,55,54,55,54,55,54,55,54,55,54,55,54,55,54,55,54,55,54,55,54,55,54,55,54,55,54,55,54,55,54,55,54,55,54,55,54,55,54,55,54,55,54,55,54,55,54,55,54,55,54,55,54,55,54,55,54,55,54,55,54,55,54,55,54,55,54,55,54,55,54,55,54,55,54,55,54,55,54,55,54,55,54,55,54,55,54,55,54,55,54,55,54,55,54,55,54,55,54,55,54,55,54,55,54,55,54,55,54,55,54,55,54,55,54,55,54,55,54,55,54,55,54,55,54,55,54,55,54,55,54,55,54,55,54,55,54,55,54,52,53,52,53,52,53,52,53,52,53,52,53,52,53,52,53,52,53,52,53,52,53,52,53,52,53,52,53,52,53,52,53,52,53,52,53,52,53,52,53,52,53,52,53,52,53,52,53,52,53,52,53,52,53,52,53,52,53,52,53,52,53,52,53,52,53,52,53,52,53,52,53,52,53,52,53,52,53,52,53,52,53,52,53,52,53,52,53,52,53,52,53,52,53,52,53,52,53,52,53,52,53,52,53,52,53,52,53,52,53,52,53,52,53,52,53,52,53,52,53,52,53,52,53,52,53,52,53,52,53,52,53,52,53,52,53,52,53,52,53,52,53,52,53,52,53,52,53,52,53,52,53,52,53,52,53,52,53,52,53,52,53,52,53,52,53,52,53,52,53,52,53,52,53,52,53,52,53,52,53,52,53,52,53,52,53,52,53,52,53,52,53,52,53,52,53,52,53,52,53,52,53,52,53,52,53,52,53,52,53,52,53,52,53,52,53,52,53,52,53,52,53,52,53,52,53,52,53,52,53,52,53,52,53,52,53,52,53,52,53,52,53,52,53,52,53,52,53,52,53,52,53,52,53,52,53,52,53,52,53,52,53,52,53,52,53,52,53,52,53,52,53,52,53,52,53,52,53,52,53,52,53,52,53,52,53,52,53,52,53,52,53,52,53,52,53,52,53,52,53,52,53,52,53,52,53,52,53,52,53,52,53,52,53,52,53,52,53,52,53,52,53,52,53,52,53,52,53,52,53,52,53,52,53,52,53,52,53,52,53,52,53,52,53,52
22,23,22,23,22,23,22,23,22,23,22,23,22,23,22,23,22,23,22,23,22,23,22,26,27,23,22,23,22,23,22,23,22,23,22,23,22,23,22,23,22,23,22,23,22,23,22,23,22,23,22,23,22,23,22,23,22,23,22,23,22,23,22,23,22,23,22,23,22,23,22,23,22,23,22,23,22,23,22,23,22,23,22,23,22,23,22,23,22,23,22,23,22,23,22,23,22,23,22,23,22,23,22,23,22,23,22,23,22,23,22,23,22,23,22,23,22,23,22,23,22,23,22,23,22,23,22,23,22,23,22,23,22,23,22,23,22,23,22,23,22,23,22,23,22,23,22,23,22,23,22,23,22,23,22,23,22,23,22,23,22,23,22,23,22,23,22,20,21,20,21,20,21,20,21,20,21,20,21,20,21,20,21,20,21,20,21,20,21,20,21,20,21,20,21,20,21,20,21,20,21,20,21,20,21,20,21,20,21,20,21,20,21,20,21,20,21,20,21,20,21,20,21,20,21,20,21,20,21,20,21,20,21,20,21,20,21,20,21,20,21,20,21,20,21,20,21,20,21,20,21,20,21,20,21,20,21,20,21,20,21,20,21,20,21,20,21,20,21,20,21,20,21,20,21,20,21,20,21,20,21,20,21,20,21,20,21,20,21,20,21,20,21,20,21,20,21,20,21,20,21,20,21,20,21,20,21,20,21,20,21,20,21,20,21,20,21,20,21,20,21,20,21,20,21,20,21,20,21,20,21,20,21,20,21,20,21,20,21,20,21,20,21,20,21,20,21,20,21,20,21,20,21,20,21,20,21,20,21,20,21,20,21,20,21,20,21,20,21,20,21,20,21,20,21,20,21,20,21,20,21,20,21,20,21,20,21,20,21,20,21,20,21,20,21,20,21,20,21,20,21,20,21,20,21,20,21,20,21,20,21,20,21,20,21,20,21,20,21,20,21,20,21,20,21,20,21,20,21,20,21,20,21,20,21,20,21,20,21,20,21,20,21,20,21,20,21,20,21,20,21,20,21,20,21,20,21,20,21,20,21,20,21,20,21,20,21,20,21,20,21,20,21,20,21,20,21,20,21,20,21,20,21,20,21,20,21,20,21,20,21,20,21,20,21,20,21,20,21,20,21,20,21,20,21,20,21,20,21,20,21,20
54,55,54,55,54,55,54,55,54,55,54,55,54,55,54,55,54,55,54,55,54,55,54,58,59,55,54,55,54,55,54,55,54,55,54,55,54,55,54,55,54,55,54,55,54,55,54,55,54,55,54,55,54,55,54,55,54,55,54,55,54,55,54,55,54,55,54,55,54,55,54,55,54,55,54,55,54,55,54,55,54,55,54,55,54,55,54,55,54,55,54,55,54,55,54,55,54,55,54,55,54,55,54,55,54,55,54,55,54,55,54,55,54,55,54,55,54,55,54,55,54,55,54,55,54,55,54,55,54,55,54,55,54,55,54,55,54,55,54,55,54,55,54,55,54,55,54,55,54,55,54,55,54,55,54,55,54,55,54,55,54,55,54,55,54,55,54,52,53,52,53,52,53,52,53,52,53,52,53,52,53,52,53,52,53,52,53,52,53,52,53,52,53,52,53,52,53,52,53,52,53,52,53,52,53,52,53,52,53,52,53,52,53,52,53,52,53,52,53,52,53,52,53,52,53,52,53,52,53,52,53,52,53,52,53,52,53,52,53,52,53,52,53,52,53,52,53,52,53,52,53,52,53,52,53,52,53,52,53,52,53,52,53,52,53,52,53,52,53,52,53,52,53,52,53,52,53,52,53,52,53,52,53,52,53,52,53,52,53,52,53,52,53,52,53,52,53,52,53,52,53,52,53,52,53,52,53,52,53,52,53,52,53,52,53,52,53,52,53,52,53,52,53,52,53,52,53,52,53,52,53,52,53,52,53,52,53,52,53,52,53,52,53,52,53,52,53,52,53,52,53,52,53,52,53,52,53,52,53,52,53,52,53,52,53,52,53,52,53,52,53,52,53,52,53,52,53,52,53,52,53,52,53,52,53,52,53,52,53,52,53,52,53,52,53,52,53,52,53,52,53,52,53,52,53,52,53,52,53,52,53,52,53,52,53,52,53,52,53,52,53,52,53,52,53,52,53,52,53,52,53,52,53,52,53,52,53,52,53,52,53,52,53,52,53,52,53,52,53,52,53,52,53,52,53,52,53,52,53,52,53,52,53,52,53,52,53,52,53,52,53,52,53,52,53,52,53,52,53,52,53,52,53,52,53,52,53,52,53,52,53,52,53,52,53,52,53,52,53,52,53,52,53,52,53,52,53,52,53,52,53,52
22,23,22,23,22,23,22,23,22,23,22,23,22,23,22,23,22,23,22,23,22,23,22,23,22,23,22,23,22,23,22,23,22,23,22,23,22,23,22,23,22,23,22,23,22,23,22,23,22,23,22,23,22,23,22,23,22,23,22,23,22,23,22,23,22,23,22,23,22,23,22,23,22,23,22,23,22,23,22,23,22,23,22,23,22,23,22,23,22,23,22,23,22,23,22,23,22,23,22,23,22,23,22,23,22,23,22,23,22,23,22,23,22,23,22,23,22,23,22,23,22,23,22,23,22,23,22,23,22,23,22,23,22,23,22,23,22,23,22,23,22,23,22,23,22,23,22,23,22,23,22,23,22,23,22,23,22,23,22,23,22,23,22,23,22,23,22,20,21,20,21,20,21,20,21,20,21,20,21,20,21,20,21,20,21,20,21,20,21,20,21,20,21,20,21,20,21,20,21,20,21,20,21,20,21,20,21,20,21,20,21,20,21,20,21,20,21,20,21,20,21,20,21,20,21,20,21,20,21,20,21,20,21,20,21,20,21,20,21,20,21,20,21,20,21,20,21,20,21,20,21,20,21,20,21,20,21,20,21,20,21,20,21,20,21,20,21,20,21,20,21,20,21,20,21,20,21,20,21,20,21,20,21,20,21,20,21,20,21,20,21,20,21,20,21,20,21,20,21,20,21,20,21,20,21,20,21,20,21,20,21,20,21,20,21,20,21,20,21,20,21,20,21,20,21,20,21,20,21,20,21,20,21,20,21,20,21,20,21,20,21,20,21,20,21,20,21,20,21,20,21,20,21,20,21,20,21,20,21,20,21,20,21,20,21,20,21,20,21,20,21,20,21,20,21,20,21,20,21,20,21,20,21,20,21,20,21,20,21,20,21,20,21,20,21,20,21,20,21,20,21,20,21,20,21,20,21,20,21,20,21,20,21,20,21,20,21,20,21,20,21,20,21,20,21,20,21,20,21,20,21,20,21,20,21,20,21,20,21,20,21,20,21,20,21,20,21,20,21,20,21,20,21,20,21,20,21,20,21,20,21,20,21,20,21,20,21,20,21,20,21,20,21,20,21,20,21,20,21,20,21,20,21,20,21,20,21,20,21,20,21,20,21,20,21,20,21,20,21,20,21,20,21,20,21,20,21,20,21,20,21,20
54,55,54,55,54,55,54,55,54,55,54,55,54,55,54,55,54,55,54,55,54,55,54,55,54,55,54,55,54,55,54,55,54,55,54,55,54,55,54,55,54,55,54,55,54,55,54,55,54,55,54,55,54,55,54,55,54,55,54,55,54,55,54,55,54,55,54,55,54,55,54,55,54,55,54,55,54,55,54,55,54,55,54,55,54,55,54,55,54,55,54,55,54,55,54,55,54,55,54,55,54,55,54,55,54,55,54,55,54,55,54,55,54,55,54,55,54,55,54,55,54,55,54,55,54,55,54,55,54,55,54,55,54,55,54,55,54,55,54,55,54,55,54,55,54,55,54,55,54,55,54,55,54,55,54,55,54,55,54,55,54,55,54,55,54,55,54,52,53,52,53,52,53,52,53,52,53,52,53,52,53,52,53,52,53,52,53,52,53,52,53,52,53,52,53,52,53,52,53,52,53,52,53,52,53,52,53,52,53,52,53,52,53,52,53,52,53,52,53,52,53,52,53,52,53,52,53,52,53,52,53,52,53,52,53,52,53,52,53,52,53,52,53,52,53,52,53,52,53,52,53,52,53,52,53,52,53,52,53,52,53,52,53,52,53,52,53,52,53,52,53,52,53,52,53,52,53,52,53,52,53,52,53,52,53,52,53,52,53,52,53,52,53,52,53,52,53,52,53,52,53,52,53,52,53,52,53,52,53,52,53,52,53,52,53,52,53,52,53,52,53,52,53,52,53,52,53,52,53,52,53,52,53,52,53,52,53,52,53,52,53,52,53,52,53,52,53,52,53,52,53,52,53,52,53,52,53,52,53,52,53,52,53,52,53,52,53,52,53,52,53,52,53,52,53,52,53,52,53,52,53,52,53,52,53,52,53,52,53,52,53,52,53,52,53,52,53,52,53,52,53,52,53,52,53,52,53,52,53,52,53,52,53,52,53,52,53,52,53,52,53,52,53,52,53,52,53,52,53,52,53,52,53,52,53,52,53,52,53,52,53,52,53,52,53,52,53,52,53,52,53,52,53,52,53,52,53,52,53,52,53,52,53,52,53,52,53,52,53,52,53,52,53,52,53,52,53,52,53,52,53,52,53,52,53,52,53,52,53,52,53,52,53,52,53,52,53,52,53,52,53,52,53,52,53,52,53,52,53,52,53,52
22,23,22,23,22,23,22,23,22,23,22,23,22,23,22,23,22,23,22,23,22,23,22,23,22,23,22,23,22,23,22,23,22,23,22,23,22,23,22,23,22,23,22,23,22,23,22,23,22,23,28,29,22,23,22,23,22,23,22,23,22,23,22,23,22,23,22,23,22,23,22,23,22,23,22,23,22,23,22,23,22,23,22,23,22,23,22,23,22,23,22,23,22,23,22,23,22,26,27,23,22,23,22,23,22,23,22,23,22,23,22,23,22,23,22,23,22,23,22,23,22,23,22,23,22,23,22,23,22,23,22,23,22,23,22,23,22,23,22,23,22,23,22,23,22,23,22,23,22,23,22,23,22,23,22,23,22,23,22,23,22,23,22,23,22,23,22,20,21,20,21,20,21,20,21,20,21,20,21,20,21,20,21,20,21,20,21,20,21,20,21,20,21,20,21,20,21,20,21,20,21,20,21,20,21,20,21,20,21,20,21,20,21,20,21,20,21,20,21,20,21,20,21,20,21,20,21,20,21,20,21,20,21,20,21,20,21,20,21,20,21,20,21,20,21,20,21,20,21,20,21,20,21,20,21,20,21,20,21,20,21,20,21,20,21,20,21,20,21,20,21,20,21,20,21,20,21,20,21,20,21,20,21,20,21,20,21,20,21,20,21,20,21,20,21,20,21,20,21,20,21,20,21,20,21,20,21,20,21,20,21,20,21,20,21,20,21,20,21,20,21,20,21,20,21,20,21,20,21,20,21,20,21,20,21,20,21,20,21,20,21,20,21,20,21,20,21,20,21,20,21,20,21,20,21,20,21,20,21,20,21,20,21,20,21,20,21,20,21,20,21,20,21,20,21,20,21,20,21,20,21,20,21,20,21,20,21,20,21,20,21,20,21,20,21,20,21,20,21,20,21,20,21,20,21,20,21,20,21,20,21,20,21,20,21,20,21,20,21,20,21,20,21,20,21,20,21,20,21,20,21,20,21,20,21,20,21,20,21,20,21,20,21,20,21,20,21,20,21,20,21,20,21,20,21,20,21,20,21,20,21,20,21,20,21,20,21,20,21,20,21,20,21,20,21,20,21,20,21,20,21,20,21,20,21,20,21,20,21,20,21,20,21,20,21,20,21,20,21,20,21,20,21,20,21,20,21,20,21,20,21,20
54,55,54,55,54,55,54,55,54,55,54,55,54,55,54,55,54,55,54,55,54,55,54,55,54,55,54,55,54,55,54,55,54,55,54,55,54,55,54,55,54,55,54,55,54,55,54,55,54,55,60,61,54,55,54,55,54,55,54,55,54,55,54,55,54,55,54,55,54,55,54,55,54,55,54,55,54,55,54,55,54,55,54,55,54,55,54,55,54,55,54,55,54,55,54,55,54,58,59,55,54,55,54,55,54,55,54,55,54,55,54,55,54,55,54,55,54,55,54,55,54,55,54,55,54,55,54,55,54,55,54,55,54,55,54,55,54,55,54,55,54,55,54,55,54,55,54,55,54,55,54,55,54,55,54,55,54,55,54,55,54,55,54,55,54,55,54,52,53,52,53,52,53,52,53,52,53,52,53,52,53,52,53,52,53,52,53,52,53,52,53,52,53,52,53,52,53,52,53,52,53,52,53,52,53,52,53,52,53,52,53,52,53,52,53,52,53,52,53,52,53,52,53,52,53,52,53,52,53,52,53,52,53,52,53,52,53,52,53,52,53,52,53,52,53,52,53,52,53,52,53,52,53,52,53,52,53,52,53,52,53,52,53,52,53,52,53,52,53,52,53,52,53,52,53,52,53,52,53,52,53,52,53,52,53,52,53,52,53,52,53,52,53,52,53,52,53,52,53,52,53,52,53,52,53,52,53,52,53,52,53,52,53,52,53,52,53,52,53,52,53,52,53,52,53,52,53,52,53,52,53,52,53,52,53,52,53,52,53,52,53,52,53,52,53,52,53,52,53,52,53,52,53,52,53,52,53,52,53,52,53,52,53,52,53,52,53,52,53,52,53,52,53,52,53,52,53,52,53,52,53,52,53,52,53,52,53,52,53,52,53,52,53,52,53,52,53,52,53,52,53,52,53,52,53,52,53,52,53,52,53,52,53,52,53,52,53,52,53,52,53,52,53,52,53,52,53,52,53,52,53,52,53,52,53,52,53,52,53,52,53,52,53,52,53,52,53,52,53,52,53,52,53,52,53,52,53,52,53,52,53,52,53,52,53,52,53,52,53,52,53,52,53,52,53,52,53,52,53,52,53,52,53,52,53,52,53,52,53,52,53,52,53,52,53,52,53,52,53,52,53,52,53,52,53,52,53,52,53,52,53,52
22,23,22,23,22,23,22,23,22,23,22,23,22,23,22,23,22,23,22,23,22,23,22,23,22,23,22,23,22,23,22,23,22,23,22,23,22,23,22,23,22,23,22,23,22,23,22,23,22,23,22,23,22,23,22,23,22,23,22,23,22,23,22,23,22,23,22,23,22,23,22,23,22,23,22,23,22,23,22,23,22,23,22,23,22,23,22,23,22,23,22,23,22,23,22,23,22,23,22,23,22,23,22,23,22,23,22,23,22,23,22,23,22,23,22,23,22,23,22,23,22,23,22,23,22,23,22,23,22,23,22,23,22,23,22,23,22,23,22,23,22,23,22,23,22,23,22,23,22,23,22,23,22,23,22,23,22,23,22,23,22,23,22,23,22,23,22,20,21,20,21,20,21,20,21,20,21,20,21,20,21,20,21,20,21,20,21,20,21,20,21,20,21,20,21,20,21,20,21,20,21,20,21,20,21,20,21,20,21,20,21,20,21,20,21,20,21,20,21,20,21,20,21,20,21,20,21,20,21,20,21,20,21,20,21,20,21,20,21,20,21,20,21,20,21,20,21,20,21,20,21,20,21,20,21,20,21,20,21,20,21,20,21,20,21,20,21,20,21,20,21,20,21,20,21,20,21,20,21,20,21,20,21,20,21,20,21,20,21,20,21,20,21,20,21,20,21,20,21,20,21,20,21,20,21,20,21,20,21,20,21,20,21,20,21,20,21,20,21,20,21,20,21,20,21,20,21,20,21,20,21,20,21,20,21,20,21,20,21,20,21,20,21,20,21,20,21,20,21,20,21,20,21,20,21,20,21,20,21,20,21,20,21,20,21,20,21,20,21,20,21,20,21,20,21,20,21,20,21,20,21,20,21,20,21,20,21,20,21,20,21,20,21,20,21,20,21,20,21,20,21,20,21,20,21,20,21,20,21,20,21,20,21,20,21,20,21,20,21,20,21,20,21,20,21,20,21,20,21,20,21,20,21,20,21,20,21,20,21,20,21,20,21,20,21,20,21,20,21,20,21,20,21,20,21,20,21,20,21,20,21,20,21,20,21,20,21,20,21,20,21,20,21,20,21,20,21,20,21,20,21,20,21,20,21,20,21,20,21,20,21,20,21,20,21,20,21,20,21,20,21,20,21,20,21,20,21,20,21,20,21,20
54,55,54,55,54,55,54,55,54,55,54,55,54,55,54,55,54,55,54,55,54,55,54,55,54,55,54,55,54,55,54,55,54,55,54,55,54,55,54,55,54,55,54,55,54,55,54,55,54,55,54,55,54,55,54,55,54,55,54,55,54,55,54,55,54,55,54,55,54,55,54,55,54,55,54,55,54,55,54,55,54,55,54,55,54,55,54,55,54,55,54,55,54,55,54,55,54,55,54,55,54,55,54,55,54,55,54,55,54,55,54,55,54,55,54,55,54,55,54,55,54,55,54,55,54,55,54,55,54,55,54,55,54,55,54,55,54,55,54,55,54,55,54,55,54,55,54,55,28,29,54,55,54,55,54,55,54,55,54,55,54,55,54,55,54,55,54,52,53,52,53,52,53,52,53,52,53,52,53,52,53,52,53,52,53,52,53,52,53,52,53,52,53,52,53,52,53,52,53,52,53,52,53,52,53,52,53,52,53,52,53,52,53,52,53,52,53,52,53,52,53,52,53,52,53,52,53,52,53,52,53,52,53,52,53,52,53,52,53,52,53,52,53,52,53,52,53,52,53,52,53,52,53,52,53,52,53,52,53,52,53,52,53,52,53,52,53,52,53,52,53,52,53,52,53,52,53,52,53,52,53,52,53,52,53,52,53,52,53,52,53,52,53,52,53,52,53,52,53,52,53,52,53,52,53,52,53,52,53,52,53,52,53,52,53,52,53,52,53,52,53,52,53,52,53,52,53,52,53,52,53,52,53,52,53,52,53,52,53,52,53,52,53,52,53,52,53,52,53,52,53,52,53,52,53,52,53,52,53,52,53,52,53,52,53,52,53,52,53,52,53,52,53,52,53,52,53,52,53,52,53,52,53,52,53,52,53,52,53,52,53,52,53,52,53,52,53,52,53,52,53,52,53,52,53,52,53,52,53,52,53,52,53,52,53,52,53,52,53,52,53,52,53,52,53,52,53,52,53,52,53,52,53,52,53,52,53,52,53,52,53,52,53,52,53,52,53,52,53,52,53,52,53,52,53,52,53,52,53,52,53,52,53,52,53,52,53,52,53,52,53,52,53,52,53,52,53,52,53,52,53,52,53,52,53,52,53,52,53,52,53,52,53,52,53,52,53,52,53,52,53,52,53,52,53,52,53,52,53,52,53,52
22,23,22,23,22,23,22,23,22,23,22,23,22,23,22,23,22,23,22,23,22,23,22,23,22,23,22,23,22,23,22,23,22,23,22,23,22,23,22,23,22,23,22,23,22,23,22,23,22,23,22,23,22,23,22,23,22,23,22,23,22,23,22,23,22,23,22,23,22,23,22,23,22,23,22,23,22,23,22,23,22,23,22,23,22,23,22,23,22,23,22,23,22,23,22,23,22,23,22,23,22,23,22,23,22,23,22,23,22,23,22,23,22,23,22,23,22,23,22,23,22,23,22,23,22,23,22,23,22,23,22,23,22,23,22,23,22,23,22,23,22,23,22,23,22,23,22,23,60,61,22,23,22,23,22,23,22,23,22,23,22,23,22,23,22,23,22,20,21,20,21,20,21,20,21,20,21,20,21,20,21,20,21,20,21,20,21,20,21,20,21,20,21,20,21,20,21,20,21,20,21,20,21,20,21,20,21,20,21,20,21,20,21,20,21,20,21,20,21,20,21,20,21,20,21,20,21,20,21,20,21,20,21,20,21,20,21,20,21,20,21,20,21,20,21,20,21,20,21,20,21,20,21,20,21,20,21,20,21,20,21,20,21,20,21,20,21,20,21,20,21,20,21,20,21,20,21,20,21,20,21,20,21,20,21,20,21,20,21,20,21,20,21,20,21,20,21,20,21,20,21,20,21,20,21,20,21,20,21,20,21,20,21,20,21,20,21,20,21,20,21,20,21,20,21,20,21,20,21,20,21,20,21,20,21,20,21,20,21,20,21,20,21,20,21,20,21,20,21,20,21,20,21,20,21,20,21,20,21,20,21,20,21,20,21,20,21,20,21,20,21,20,21,20,21,20,21,20,21,20,21,20,21,20,21,20,21,20,21,20,21,20,21,20,21,20,21,20,21,20,21,20,21,20,21,20,21,20,21,20,21,20,21,20,21,20,21,20,21,20,21,20,21,20,21,20,21,20,21,20,21,20,21,20,21,20,21,20,21,20,21,20,21,20,21,20,21,20,21,20,21,20,21,20,21,20,21,20,21,20,21,20,21,20,21,20,21,20,21,20,21,20,21,20,21,20,21,20,21,20,21,20,21,20,21,20,21,20,21,20,21,20,21,20,21,20,21,20,21,20,21,20,21,20,21,20,21,20,21,20,21,20
54,55,54,55,54,55,54,55,54,55,54,55,54,55,54,55,54,55,54,55,54,55,54,55,54,55,54,55,54,55,54,55,54,55,54,55,54,55,54,55,54,55,54,55,54,55,54,55,54,55,54,55,54,55,54,55,54,55,54,55,54,55,54,55,54,55,54,55,54,55,54,55,54,55,54,55,54,55,54,55,54,55,54,55,54,55,54,55,54,55,54,55,54,55,54,55,54,55,54,55,54,55,54,55,54,55,54,55,54,55,54,55,54,55,54,55,54,55,54,55,54,55,54,55,54,55,54,55,54,55,54,55,54,55,54,55,54,55,54,55,54,55,54,55,54,55,54,55,54,55,54,55,54,55,54,55,54,55,54,55,54,55,54,55,54,55,54,52,53,52,53,52,53,52,53,52,53,52,53,52,53,52,53,52,53,52,53,52,53,52,53,52,53,52,53,52,53,52,53,52,53,52,53,52,53,52,53,52,53,52,53,52,53,52,53,52,53,52,53,52,53,52,53,52,53,52,53,52,53,52,53,52,53,52,53,52,53,52,53,52,53,52,53,52,53,52,53,52,53,52,53,52,53,52,53,52,53,52,53,52,53,52,53,52,53,52,53,52,53,52,53,52,53,52,53,52,53,52,53,52,53,52,53,52,53,52,53,52,53,52,53,52,53,52,53,52,53,52,53,52,53,52,53,52,53,52,53,52,53,52,53,52,53,52,53,52,53,52,53,52,53,52,53,52,53,52,53,52,53,52,53,52,53,52,53,52,53,52,53,52,53,52,53,52,53,52,53,52,53,52,53,52,53,52,53,52,53,52,53,52,53,52,53,52,53,52,53,52,53,52,53,52,53,52,53,52,53,52,53,52,53,52,53,52,53,52,53,52,53,52,53,52,53,52,53,52,53,52,53,52,53,52,53,52,53,52,53,52,53,52,53,52,53,52,53,52,53,52,53,52,53,52,53,52,53,52,53,52,53,52,53,52,53,52,53,52,53,52,53,52,53,52,53,52,53,52,53,52,53,52,53,52,53,52,53,52,53,52,53,52,53,52,53,52,53,52,53,52,53,52,53,52,53,52,53,52,53,52,53,52,53,52,53,52,53,52,53,52,53,52,53,52,53,52,53,52,53,52,53,52,53,52,53,52,53,52,53,52,53,52,53,52
22,23,22,23,22,23,22,23,22,23,22,23,22,23,22,23,22,23,22,23,22,23,22,23,22,23,22,23,22,23,22,23,22,23,22,23,22,23,22,23,22,23,22,23,22,23,22,23,22,23,22,23,22,23,22,23,22,23,22,23,22,23,22,23,22,23,22,23,22,23,22,23,22,23,22,23,22,23,22,23,22,23,22,23,22,23,22,23,22,23,22,23,22,23,22,23,22,23,22,23,22,23,22,23,22,23,22,23,22,23,22,23,22,23,22,23,22,23,22,23,22,23,22,23,22,23,22,23,22,23,22,23,22,23,22,23,22,23,22,23,22,23,22,23,22,23,22,23,22,23,22,23,22,23,22,23,22,23,22,23,22,23,22,23,22,23,22,20,21,20,21,20,21,20,21,20,21,20,21,20,21,20,21,20,21,20,21,20,21,20,21,20,21,20,21,20,21,20,21,20,21,20,21,20,21,20,21,20,21,20,21,20,21,20,21,20,21,20,21,20,21,20,21,20,21,20,21,20,21,20,21,20,21,20,21,20,21,20,21,20,21,20,21,20,21,20,21,20,21,20,21,20,21,20,21,20,21,20,21,20,21,20,21,20,21,20,21,20,21,20,21,20,21,20,21,20,21,20,21,20,21,20,21,20,21,20,21,20,21,20,21,20,21,20,21,20,21,20,21,20,21,20,21,20,21,20,21,20,21,20,21,20,21,20,21,20,21,20,21,20,21,20,21,20,21,20,21,20,21,20,21,20,21,20,21,20,21,20,21,20,21,20,21,20,21,20,21,20,21,20,21,20,21,20,21,20,21,20,21,20,21,20,21,20,21,20,21,20,21,20,21,20,21,20,21,20,21,20,21,20,21,20,21,20,21,20,21,20,21,20,21,20,21,20,21,20,21,20,21,20,21,20,21,20,21,20,21,20,21,20,21,20,21,20,21,20,21,20,21,20,21,20,21,20,21,20,21,20,21,20,21,20,21,20,21,20,21,20,21,20,21,20,21,20,21,20,21,20,21,20,21,20,21,20,21,20,21,20,21,20,21,20,21,20,21,20,21,20,21,20,21,20,21,20,21,20,21,20,21,20,21,20,21,20,21,20,21,20,21,20,21,20,21,20,21,20,21,20,21,20,21,20,21,20,21,20,21,20,21,20,21,20
54,55,54,55,54,55,54,55,54,55,54,55,54,55,54,55,54,55,54,55,54,55,54,55,54,55,54,55,54,55,54,55,54,55,54,55,54,55,54,55,54,55,54,55,54,55,54,55,54,55,54,55,54,55,54,55,54,55,54,55,54,55,54,55,54,55,54,55,54,55,54,55,54,55,54,55,54,55,54,55,54,55,54,55,54,55,54,55,54,55,54,55,54,55,54,55,54,55,54,55,54,55,54,55,54,55,54,55,54,55,54,55,54,55,54,55,54,55,54,55,54,55,54,55,54,55,54,55,54,55,54,55,54,55,54,55,54,55,54,55,54,55,54,55,54,55,54,55,54,55,54,55,54,55,54,55,54,55,54,55,54,55,54,55,54,55,54,52,53,52,53,52,53,52,53,52,53,52,53,52,53,52,53,52,53,52,53,52,53,52,53,52,53,52,53,52,53,52,53,52,53,52,53,52,53,52,53,52,53,52,53,52,53,52,53,52,53,52,53,52,53,52,53,52,53,52,53,52,53,52,53,52,53,52,53,52,53,52,53,52,53,52,53,52,53,52,53,52,53,52,53,52,53,52,53,52,53,52,53,52,53,52,53,52,53,52,53,52,53,52,53,52,53,52,53,52,53,52,53,52,53,52,53,52,53,52,53,52,53,52,53,52,53,52,53,52,53,52,53,52,53,52,53,52,53,52,53,52,53,52,53,52,53,52,53,52,53,52,53,52,53,52,53,52,53,52,53,52,53,52,53,52,53,52,53,52,53,52,53,52,53,52,53,52,53,52,53,52,53,52,53,52,53,52,53,52,53,52,53,52,53,52,53,52,53,52,53,52,53,52,53,52,53,52,53,52,53,52,53,52,53,52,53,52,53,52,53,52,53,52,53,52,53,52,53,52,53,52,53,52,53,52,53,52,53,52,53,52,53,52,53,52,53,52,53,52,53,52,53,52,53,52,53,52,53,52,53,52,53,52,53,52,53,52,53,52,53,52,53,52,53,52,53,52,53,52,53,52,53,52,53,52,53,52,53,52,53,52,53,52,53,52,53,52,53,52,53,52,53,52,53,52,53,52,53,52,53,52,53,52,53,52,53,52,53,52,53,52,53,52,53,52,53,52,53,52,53,52,53,52,53,52,53,52,53,52,53,52,53,52,53,52
22,23,22,23,22,23,22,23,22,23,22,23,22,23,22,23,22,23,22,23,22,23,22,23,22,23,22,23,22,23,22,23,22,23,22,23,22,23,22,23,22,23,22,23,22,23,22,23,22,23,22,23,22,23,22,23,22,23,22,23,22,23,22,23,22,23,22,23,22,23,22,23,22,23,22,23,22,23,22,23,22,23,22,23,22,23,22,23,22,23,22,23,22,23,22,23,22,23,22,23,22,23,22,23,22,23,22,23,22,23,22,23,22,23,22,23,22,23,22,23,22,23,22,23,22,23,22,23,22,23,22,23,22,23,22,23,22,23,22,23,22,23,22,23,22,23,22,23,22,23,22,23,22,23,22,23,22,23,22,23,22,23,22,23,22,23,22,20,21,20,21,20,21,20,21,20,21,20,21,20,21,20,21,20,21,20,21,20,21,20,21,20,21,20,21,20,21,20,21,20,21,20,21,20,21,20,21,20,21,20,21,20,21,20,21,20,21,20,21,20,21,20,21,20,21,20,21,20,21,20,21,20,21,20,21,20,21,20,21,20,21,20,21,20,21,20,21,20,21,20,21,20,21,20,21,20,21,20,21,20,21,20,21,20,21,20,21,20,21,20,21,20,21,20,21,20,21,20,21,20,21,20,21,20,21,20,21,20,21,20,21,20,21,20,21,20,21,20,21,20,21,20,21,20,21,20,21,20,21,20,21,20,21,20,21,20,21,20,21,20,21,20,21,20,21,20,21,20,21,20,21,20,21,20,21,20,21,20,21,20,21,20,21,20,21,20,21,20,21,20,21,20,21,20,21,20,21,20,21,20,21,20,21,20,21,20,21,20,21,20,21,20,21,20,21,20,21,20,21,20,21,20,21,20,21,20,21,20,21,20,21,20,21,20,21,20,21,20,21,20,21,20,21,20,21,20,21,20,21,20,21,20,21,20,21,20,21,20,21,20,21,20,21,20,21,20,21,20,21,20,21,20,21,20,21,20,21,20,21,20,21,20,21,20,21,20,21,20,21,20,21,20,21,20,21,20,21,20,21,20,21,20,21,20,21,20,21,20,21,20,21,20,21,20,21,20,21,20,21,20,21,20,21,20,21,20,21,20,21,20,21,20,21,20,21,20,21,20,21,20,21,20,21,20,21,20,21,20,21,20,21,20
54,55,54,55,54,55,54,55,54,55,54,55,54,55,54,55,54,55,54,55,54,55,54,55,54,55,54,55,54,55,54,55,54,55,54,55,54,55,54,55,54,55,54,55,54,55,54,55,54,55,54,55,54,55,54,55,54,55,54,55,54,55,54,55,54,55,54,55,54,55,54,55,54,55,54,55,54,55,54,55,54,55,54,55,54,55,54,55,54,55,54,55,54,55,54,55,54,55,54,55,54,55,54,55,54,55,54,55,54,55,54,55,54,55,54,55,54,55,54,55,54,55,54,55,54,55,54,55,54,55,54,55,54,55,54,55,54,55,54,55,54,55,54,55,54,55,54,55,54,55,54,55,54,55,54,55,54,55,54,55,54,55,54,55,54,55,54,52,53,52,53,52,53,52,53,52,53,52,53,52,53,52,53,52,53,52,53,52,53,52,53,52,53,52,53,52,53,52,53,52,53,52,53,52,53,52,53,52,53,52,53,52,53,52,53,52,53,52,53,52,53,52,53,52,53,52,53,52,53,52,53,52,53,52,53,52,53,52,53,52,53,52,53,52,53,52,53,52,53,52,53,52,53,52,53,52,53,52,53,52,53,52,53,52,53,52,53,52,53,52,53,52,53,52,53,52,53,52,53,52,53,52,53,52,53,52,53,52,53,52,53,52,53,52,53,52,53,52,53,52,53,52,53,52,53,52,53,52,53,52,53,52,53,52,53,52,53,52,53,52,53,52,53,52,53,52,53,52,53,52,53,52,53,52,53,52,53,52,53,52,53,52,53,52,53,52,53,52,53,52,53,52,53,52,53,52,53,52,53,52,53,52,53,52,53,52,53,52,53,52,53,52,53,52,53,52,53,52,53,52,53,52,53,52,53,52,53,52,53,52,53,52,53,52,53,52,53,52,53,52,53,52,53,52,53,52,53,52,53,52,53,52,53,52,53,52,53,52,53,52,53,52,53,52,53,52,53,52,53,52,53,52,53,52,53,52,53,52,53,52,53,52,53,52,53,52,53,52,53,52,53,52,53,52,53,52,53,52,53,52,53,52,53,52,53,52,53,52,53,52,53,52,53,52,53,52,53,52,53,52,53,52,53,52,53,52,53,52,53,52,53,52,53,52,53,52,53,52,53,52,53,52,53,52,53,52,53,52,53,52,53,52
